12 12 12 12 12 17 17 17 17 17 17 12 12 12 12 12 12 12 12 12 12 12 12 12 12 12 12 12 12 12 12 12 12 12 17 17 17 17 17 17 17 17 17 17 12 12 12 12 12 12
10 10 10 16 13 13 13 13 13 13 13 19 11 11 11 11 11 11 17 17 17 17 17 17 17 17 17 17 17 11 11 11 11 18 13 13 13 13 13 13 13 13 13 13 19 11 11 11 11 11
10 10 10 10 13 13 13 13 13 13 13 19 17 17 17 17 17 17 13 13 13 13 13 13 13 13 13 13 13 19 11 11 11 18 13 13 13 13 13 13 13 13 13 13 19 11 11 11 11 11
10 10 10 10 13 13 13 13 13 13 19 18 13 13 20 20 13 13 13 13 13 13 13 13 13 13 13 13 13 19 11 11 11 18 13 13 13 13 13 13 13 13 13 13 19 11 11 11 11 11
12 12 12 16 13 13 13 13 13 13 15 15 13 13 13 13 13 13 13 13 13 13 13 13 13 13 13 13 13 15 15 15 15 15 13 13 13 13 13 13 13 13 13 13 19 11 11 11 11 11
12 12 12 18 13 13 13 13 13 13 15 15 13 13 13 13 13 13 13 13 13 13 13 13 13 13 13 13 13 15 15 15 15 15 13 13 13 13 13 13 13 13 13 13 19 11 11 11 11 11
12 12 12 18 13 13 13 13 13 13 19 18 13 13 13 13 13 13 13 13 13 13 13 13 13 13 13 13 13 19 11 11 11 18 13 13 13 13 13 13 13 13 13 13 19 11 11 11 11 11
12 12 12 18 13 13 13 13 13 13 19 18 13 13 13 13 13 13 13 13 13 13 13 13 13 13 13 13 13 19 11 11 11 18 13 13 13 13 13 13 13 13 13 13 19 11 11 11 11 11
12 12 12 18 13 13 13 13 13 13 19 18 13 13 13 13 13 13 13 13 13 13 13 13 13 13 13 13 13 19 11 11 11 11 14 14 14 14 15 15 14 14 14 14 11 11 11 11 11 11
12 12 12 12 14 14 14 14 14 14 11 18 13 13 13 13 13 13 13 19 14 15 15 14 14 14 14 14 14 17 17 17 17 17 17 17 17 17 15 15 17 17 17 11 11 11 11 11 11 11
11 11 11 11 11 11 11 11 11 11 11 18 13 13 13 13 13 13 13 19 11 15 15 11 11 11 11 11 18 13 13 13 13 13 13 13 13 13 13 13 13 13 13 19 11 11 11 11 11 11
11 11 11 11 11 11 11 11 11 11 11 11 15 15 14 14 14 14 14 11 11 15 15 11 11 11 11 11 18 13 13 13 13 13 13 13 13 13 13 13 13 13 13 19 11 11 11 11 11 11
11 11 11 11 11 11 11 11 11 11 11 11 15 15 11 11 11 11 11 11 11 15 15 11 11 11 11 11 18 13 13 13 13 13 13 13 13 13 13 13 13 13 13 19 11 11 11 11 11 11
11 11 11 17 17 17 17 17 17 17 17 17 15 15 11 11 11 17 17 17 17 15 15 17 17 17 17 11 18 13 13 13 13 13 13 13 13 13 13 13 13 13 13 19 11 11 11 11 11 11
11 11 18 13 13 13 13 13 13 13 13 13 13 13 19 11 18 13 13 13 13 13 13 13 13 13 13 19 18 13 13 13 13 13 13 13 13 13 13 13 13 13 13 19 11 11 11 11 11 11
11 11 18 13 13 13 13 13 13 13 13 13 13 13 19 11 18 13 13 13 13 13 13 13 13 13 13 19 18 13 13 13 13 13 13 13 13 13 13 13 13 13 13 17 17 17 17 17 11 11
11 11 18 13 13 13 13 13 13 13 13 13 13 13 19 11 18 13 13 13 13 13 13 13 13 13 13 15 15 13 13 13 13 13 13 13 13 13 13 13 13 13 13 13 13 13 13 13 19 11
11 11 18 13 13 13 13 13 13 13 13 13 13 15 15 15 15 13 13 13 13 13 13 13 13 13 13 15 15 13 13 13 13 13 13 13 13 13 13 13 13 13 13 13 13 13 13 13 19 11
11 11 18 13 13 13 13 13 13 13 13 13 13 15 15 15 15 13 13 13 13 13 13 13 13 13 13 19 18 13 13 13 13 13 13 13 13 13 13 13 13 13 13 13 13 13 13 13 19 11
11 11 18 13 13 13 13 13 13 13 13 13 13 19 11 11 18 13 13 13 13 13 13 13 13 13 13 19 18 13 13 13 13 13 13 13 13 13 13 13 13 13 13 13 13 13 13 13 19 11
11 11 18 13 13 13 13 13 13 13 13 13 13 19 11 11 18 13 13 13 13 13 13 13 13 13 13 19 18 13 13 13 13 13 13 13 13 13 13 13 13 13 13 13 13 13 13 13 19 11
11 11 11 14 14 14 14 14 14 14 14 14 14 11 11 11 18 13 13 13 13 13 13 13 13 13 13 19 11 14 14 14 14 14 14 14 15 15 14 14 14 14 14 14 14 14 14 14 11 11
11 11 11 11 11 11 11 11 11 11 11 11 11 11 11 11 18 13 13 13 13 13 13 13 13 13 13 19 11 11 11 11 11 11 11 11 15 15 11 11 11 11 11 11 11 11 11 11 11 11
11 11 11 11 12 12 12 12 12 12 11 11 11 11 11 11 11 14 14 14 14 14 14 14 14 14 14 11 11 11 11 11 11 11 11 11 15 15 11 11 11 11 11 11 11 11 11 11 11 11
11 11 12 11 12 11 12 11 12 11 11 11 11 11 11 11 11 11 11 11 11 11 11 11 11 11 11 11 11 11 11 11 11 11 11 11 15 15 11 11 11 11 11 11 11 11 11 11 11 11
11 12 17 17 17 17 17 17 17 17 17 17 17 11 11 11 11 11 11 11 11 11 11 11 11 11 11 11 11 11 11 11 11 11 11 11 15 15 11 11 11 11 11 11 11 11 11 11 11 11
11 18 15 15 15 15 15 15 15 15 15 15 15 19 11 11 11 11 11 11 17 17 17 17 17 17 17 17 17 17 17 17 17 17 17 17 15 15 17 17 17 17 17 17 17 17 17 11 11 11
11 18 15 15 15 15 15 15 15 15 15 15 15 19 11 11 11 11 11 18 13 13 13 13 13 13 13 13 13 13 13 13 13 13 13 13 13 13 13 13 13 13 13 13 13 13 13 19 11 11
11 18 15 15 15 15 15 15 15 15 15 15 15 19 11 11 11 11 11 18 13 13 13 13 13 13 13 13 13 13 13 13 13 13 13 13 13 13 13 13 13 13 13 13 13 13 13 19 11 11
11 18 15 15 15 15 15 15 15 15 15 15 15 19 11 11 11 11 11 18 13 13 13 13 13 13 13 13 13 13 13 13 13 13 13 13 13 13 13 13 13 13 13 13 13 13 13 19 11 11
11 18 15 15 15 15 15 15 15 15 15 15 15 19 11 11 11 11 11 18 13 13 13 13 13 13 13 13 13 13 13 13 13 13 13 13 13 13 13 13 13 13 13 13 13 13 13 19 11 11
11 18 15 15 15 15 15 15 15 15 15 15 15 19 11 11 11 11 11 18 13 13 13 13 13 13 13 13 13 13 13 13 13 13 13 13 13 13 13 13 13 13 13 13 13 13 13 19 11 11
11 18 15 15 15 15 15 15 15 15 15 15 15 19 11 11 11 11 11 18 13 13 13 13 13 13 13 13 13 13 13 13 13 13 13 13 13 13 13 13 13 13 13 13 13 13 13 19 11 11
11 18 15 15 15 15 15 15 15 15 15 15 15 19 11 17 17 17 17 17 13 13 13 13 13 13 13 13 13 13 13 13 13 13 13 13 13 13 13 13 13 13 13 13 13 13 13 19 11 11
11 11 14 14 14 15 15 14 14 14 14 14 14 11 18 13 13 13 13 13 13 13 13 13 13 13 13 13 13 13 13 13 13 13 13 13 13 13 13 13 13 13 13 13 13 13 13 19 11 11
11 11 11 11 11 15 15 11 11 11 11 11 11 11 18 13 13 13 13 13 13 13 13 13 13 13 13 13 13 13 13 13 13 13 13 13 13 13 13 13 13 13 13 13 13 13 13 19 11 11
11 11 11 11 11 15 15 15 15 15 15 15 15 15 15 13 13 13 13 13 13 13 13 13 13 13 13 13 13 13 13 13 13 13 13 13 13 13 13 13 13 13 13 13 13 13 13 19 11 11
11 11 11 11 11 15 15 15 15 15 15 15 15 15 15 13 13 13 13 13 13 13 13 13 13 13 13 13 13 13 13 13 13 13 13 13 13 13 13 13 13 13 13 13 13 13 13 19 11 11
11 11 11 11 11 11 11 11 11 11 11 11 11 11 18 13 13 13 13 13 13 13 13 13 13 13 13 13 13 13 13 13 13 13 13 13 13 13 13 13 13 13 13 13 13 13 13 19 11 11
11 11 11 11 11 11 11 11 11 11 11 11 11 11 18 13 13 13 13 13 13 13 13 13 13 13 13 13 13 13 13 13 13 13 13 13 13 13 13 13 13 13 13 13 13 13 13 19 11 11
11 11 11 11 11 11 11 11 11 11 11 11 11 11 11 14 14 14 14 14 14 14 14 14 14 14 14 14 14 14 14 14 14 14 14 14 14 14 14 14 14 14 14 14 14 14 14 11 11 11
11 11 11 11 11 11 11 11 11 11 11 11 11 11 11 11 11 11 11 11 11 11 11 11 11 11 11 11 11 11 11 11 11 11 11 11 11 11 11 11 11 11 11 11 11 11 11 11 11 11
11 11 11 11 11 11 11 11 11 11 11 11 11 11 11 11 11 11 11 11 11 11 11 11 11 11 11 11 11 11 11 11 11 11 11 11 11 11 11 11 11 11 11 11 11 11 11 11 11 11
11 11 11 11 11 11 11 11 11 11 11 11 11 11 11 11 11 11 11 11 11 11 11 11 11 11 11 11 11 11 11 11 11 11 11 11 11 11 11 11 11 11 11 11 11 11 11 11 11 11
11 11 11 11 11 11 11 11 11 11 11 11 11 11 11 11 11 11 11 11 11 11 11 11 11 11 11 11 11 11 11 11 11 11 11 11 11 11 11 11 11 11 11 11 11 11 11 11 11 11
11 11 11 11 11 11 11 11 11 11 11 11 11 11 11 11 11 11 11 11 11 11 11 11 11 11 11 11 11 11 11 11 11 11 11 11 11 11 11 11 11 11 11 11 11 11 11 11 11 11
11 11 11 11 11 11 11 11 11 11 11 11 11 11 11 11 11 11 11 11 11 11 11 11 11 11 11 11 11 11 11 11 11 11 11 11 11 11 11 11 11 11 11 11 11 11 11 11 11 11
11 11 11 11 11 11 11 11 11 11 11 11 11 11 11 11 11 11 11 11 11 11 11 11 11 11 11 11 11 11 11 11 11 11 11 11 11 11 11 11 11 11 11 11 11 11 11 11 11 11
11 11 11 11 11 11 11 11 11 11 11 11 11 11 11 11 11 11 11 11 11 11 11 11 11 11 11 11 11 11 11 11 11 11 11 11 11 11 11 11 11 11 11 11 11 11 11 11 11 11
11 11 11 11 11 11 11 11 11 11 11 11 11 11 11 11 11 11 11 11 11 11 11 11 11 11 11 11 11 11 11 11 11 11 11 11 11 11 11 11 11 11 11 11 11 11 11 11 11 11