2 2 2 2 7 7 7 7 7 7 7 2 2 2 2 2 2 2 2 2 2 2 2 2 2 2 2 2 2 2 2 2 2 2 7 7 7 7 7 7 7 7 7 7 2 2 2 2 2 2
0 0 0 6 3 3 3 3 3 3 3 9 1 1 1 1 1 1 7 7 7 7 7 7 7 7 7 7 7 1 1 1 1 8 3 3 3 3 3 3 3 3 3 3 9 1 1 1 1 1 
0 0 0 0 3 3 3 3 3 3 3 9 7 7 7 7 7 7 3 3 3 3 3 3 3 3 3 3 3 9 1 1 1 8 3 3 3 3 3 3 3 3 3 3 9 1 1 1 1 1
0 0 0 0 3 3 3 3 3 3 9 8 3 3 3 3 3 3 3 3 3 3 3 3 3 3 3 3 3 9 1 1 1 8 3 3 3 3 3 3 3 3 3 3 9 1 1 1 1 1 
2 2 2 6 3 3 3 3 3 3 5 5 3 3 3 3 3 3 3 3 3 3 3 3 3 3 3 3 3 5 5 5 5 5 3 3 3 3 3 3 3 3 3 3 9 1 1 1 1 1
2 2 2 8 3 3 3 3 3 3 5 5 3 3 3 3 3 3 3 3 3 3 3 3 3 3 3 3 3 5 5 5 5 5 3 3 3 3 3 3 3 3 3 3 9 1 1 1 1 1
2 2 2 8 3 3 3 3 3 3 9 8 3 3 3 3 3 3 3 3 3 3 3 3 3 3 3 3 3 9 1 1 1 8 3 3 3 3 3 3 3 3 3 3 9 1 1 1 1 1 
2 2 2 8 3 3 3 3 3 3 9 8 3 3 3 3 3 3 3 3 3 3 3 3 3 3 3 3 3 9 1 1 1 8 3 3 3 3 3 3 3 3 3 3 9 1 1 1 1 1
2 2 2 8 3 3 3 3 3 3 9 8 3 3 3 3 3 3 3 3 3 3 3 3 3 3 3 3 3 9 1 1 1 1 4 4 4 4 5 5 4 4 4 4 1 1 1 1 1 1
2 2 2 2 4 4 4 4 4 4 1 8 3 3 3 3 3 3 3 9 4 5 5 4 4 4 4 4 4 7 7 7 7 7 7 7 7 7 5 5 7 7 7 1 1 1 1 1 1 1
1 1 1 1 1 1 1 1 1 1 1 8 3 3 3 3 3 3 3 9 1 5 5 1 1 1 1 1 8 3 3 3 3 3 3 3 3 3 3 3 3 3 3 9 1 1 1 1 1 1
1 1 1 1 1 1 1 1 1 1 1 1 5 5 4 4 4 4 4 1 1 5 5 1 1 1 1 1 8 3 3 3 3 3 3 3 3 3 3 3 3 3 3 9 1 1 1 1 1 1
1 1 1 1 1 1 1 1 1 1 1 1 5 5 1 1 1 1 1 1 1 5 5 1 1 1 1 1 8 3 3 3 3 3 3 3 3 3 3 3 3 3 3 9 1 1 1 1 1 1
1 1 1 7 7 7 7 7 7 7 7 7 5 5 1 1 1 7 7 7 7 5 5 7 7 7 7 1 8 3 3 3 3 3 3 3 3 3 3 3 3 3 3 9 1 1 1 1 1 1
1 1 8 3 3 3 3 3 3 3 3 3 3 3 9 1 8 3 3 3 3 3 3 3 3 3 3 9 8 3 3 3 3 3 3 3 3 3 3 3 3 3 3 9 1 1 1 1 1 1
1 1 8 3 3 3 3 3 3 3 3 3 3 3 9 1 8 3 3 3 3 3 3 3 3 3 3 9 8 3 3 3 3 3 3 3 3 3 3 3 3 3 3 7 7 7 7 7 1 1
1 1 8 3 3 3 3 3 3 3 3 3 3 3 9 1 8 3 3 3 3 3 3 3 3 3 3 5 5 3 3 3 3 3 3 3 3 3 3 3 3 3 3 3 3 3 3 3 9 1 
1 1 8 3 3 3 3 3 3 3 3 3 3 5 5 5 5 3 3 3 3 3 3 3 3 3 3 5 5 3 3 3 3 3 3 3 3 3 3 3 3 3 3 3 3 3 3 3 9 1
1 1 8 3 3 3 3 3 3 3 3 3 3 5 5 5 5 3 3 3 3 3 3 3 3 3 3 9 8 3 3 3 3 3 3 3 3 3 3 3 3 3 3 3 3 3 3 3 9 1
1 1 8 3 3 3 3 3 3 3 3 3 3 9 1 1 8 3 3 3 3 3 3 3 3 3 3 9 8 3 3 3 3 3 3 3 3 3 3 3 3 3 3 3 3 3 3 3 9 1 
1 1 8 3 3 3 3 3 3 3 3 3 3 9 1 1 8 3 3 3 3 3 3 3 3 3 3 9 8 3 3 3 3 3 3 3 3 3 3 3 3 3 3 3 3 3 3 3 9 1
1 1 1 4 4 4 4 4 4 4 4 4 4 1 1 1 8 3 3 3 3 3 3 3 3 3 3 9 1 4 4 4 4 4 4 4 5 5 4 4 4 4 4 4 4 4 4 4 1 1
1 1 1 1 1 1 1 1 1 1 1 1 1 1 1 1 8 3 3 3 3 3 3 3 3 3 3 9 1 1 1 1 1 1 1 1 5 5 1 1 1 1 1 1 1 1 1 1 1 1
1 1 1 1 2 2 2 2 2 2 1 1 1 1 1 1 1 4 4 4 4 4 4 4 4 4 4 1 1 1 1 1 1 1 1 1 5 5 1 1 1 1 1 1 1 1 1 1 1 1
1 1 2 1 2 1 2 1 2 1 1 1 1 1 1 1 1 1 1 1 1 1 1 1 1 1 1 1 1 1 1 1 1 1 1 1 5 5 1 1 1 1 1 1 1 1 1 1 1 1
1 2 7 7 7 7 7 7 7 7 7 7 7 1 1 1 1 1 1 1 1 1 1 1 1 1 1 1 1 1 1 1 1 1 1 1 5 5 1 1 1 1 1 1 1 1 1 1 1 1
1 8 5 5 5 5 5 5 5 5 5 5 5 9 1 1 1 1 1 1 7 7 7 7 7 7 7 7 7 7 7 7 7 7 7 7 5 5 7 7 7 7 7 7 7 7 7 1 1 1
1 8 5 5 5 5 5 5 5 5 5 5 5 9 1 1 1 1 1 8 3 3 3 3 3 3 3 3 3 3 3 3 3 3 3 3 3 3 3 3 3 3 3 3 3 3 3 9 1 1
1 8 5 5 5 5 5 5 5 5 5 5 5 9 1 1 1 1 1 8 3 3 3 3 3 3 3 3 3 3 3 3 3 3 3 3 3 3 3 3 3 3 3 3 3 3 3 9 1 1
1 8 5 5 5 5 5 5 5 5 5 5 5 9 1 1 1 1 1 8 3 3 3 3 3 3 3 3 3 3 3 3 3 3 3 3 3 3 3 3 3 3 3 3 3 3 3 9 1 1
1 8 5 5 5 5 5 5 5 5 5 5 5 9 1 1 1 1 1 8 3 3 3 3 3 3 3 3 3 3 3 3 3 3 3 3 3 3 3 3 3 3 3 3 3 3 3 9 1 1
1 8 5 5 5 5 5 5 5 5 5 5 5 9 1 1 1 1 1 8 3 3 3 3 3 3 3 3 3 3 3 3 3 3 3 3 3 3 3 3 3 3 3 3 3 3 3 9 1 1
1 8 5 5 5 5 5 5 5 5 5 5 5 9 1 1 1 1 1 8 3 3 3 3 3 3 3 3 3 3 3 3 3 3 3 3 3 3 3 3 3 3 3 3 3 3 3 9 1 1
1 8 5 5 5 5 5 5 5 5 5 5 5 9 1 7 7 7 7 7 3 3 3 3 3 3 3 3 3 3 3 3 3 3 3 3 3 3 3 3 3 3 3 3 3 3 3 9 1 1
1 1 4 4 4 5 5 4 4 4 4 4 4 1 8 3 3 3 3 3 3 3 3 3 3 3 3 3 3 3 3 3 3 3 3 3 3 3 3 3 3 3 3 3 3 3 3 9 1 1
1 1 1 1 1 5 5 1 1 1 1 1 1 1 8 3 3 3 3 3 3 3 3 3 3 3 3 3 3 3 3 3 3 3 3 3 3 3 3 3 3 3 3 3 3 3 3 9 1 1
1 1 1 1 1 5 5 5 5 5 5 5 5 5 5 3 3 3 3 3 3 3 3 3 3 3 3 3 3 3 3 3 3 3 3 3 3 3 3 3 3 3 3 3 3 3 3 9 1 1
1 1 1 1 1 5 5 5 5 5 5 5 5 5 5 3 3 3 3 3 3 3 3 3 3 3 3 3 3 3 3 3 3 3 3 3 3 3 3 3 3 3 3 3 3 3 3 9 1 1
1 1 1 1 1 1 1 1 1 1 1 1 1 1 8 3 3 3 3 3 3 3 3 3 3 3 3 3 3 3 3 3 3 3 3 3 3 3 3 3 3 3 3 3 3 3 3 9 1 1
1 1 1 1 1 1 1 1 1 1 1 1 1 1 8 3 3 3 3 3 3 3 3 3 3 3 3 3 3 3 3 3 3 3 3 3 3 3 3 3 3 3 3 3 3 3 3 9 1 1
1 1 1 1 1 1 1 1 1 1 1 1 1 1 1 4 4 4 4 4 4 4 4 4 4 4 4 4 4 4 4 4 4 4 4 4 4 4 4 4 4 4 4 4 4 4 4 1 1 1
1 1 1 1 1 1 1 1 1 1 1 1 1 1 1 1 1 1 1 1 1 1 1 1 1 1 1 1 1 1 1 1 1 1 1 1 1 1 1 1 1 1 1 1 1 1 1 1 1 1
1 1 1 1 1 1 1 1 1 1 1 1 1 1 1 1 1 1 1 1 1 1 1 1 1 1 1 1 1 1 1 1 1 1 1 1 1 1 1 1 1 1 1 1 1 1 1 1 1 1
1 1 1 1 1 1 1 1 1 1 1 1 1 1 1 1 1 1 1 1 1 1 1 1 1 1 1 1 1 1 1 1 1 1 1 1 1 1 1 1 1 1 1 1 1 1 1 1 1 1
1 1 1 1 1 1 1 1 1 1 1 1 1 1 1 1 1 1 1 1 1 1 1 1 1 1 1 1 1 1 1 1 1 1 1 1 1 1 1 1 1 1 1 1 1 1 1 1 1 1
1 1 1 1 1 1 1 1 1 1 1 1 1 1 1 1 1 1 1 1 1 1 1 1 1 1 1 1 1 1 1 1 1 1 1 1 1 1 1 1 1 1 1 1 1 1 1 1 1 1
1 1 1 1 1 1 1 1 1 1 1 1 1 1 1 1 1 1 1 1 1 1 1 1 1 1 1 1 1 1 1 1 1 1 1 1 1 1 1 1 1 1 1 1 1 1 1 1 1 1
1 1 1 1 1 1 1 1 1 1 1 1 1 1 1 1 1 1 1 1 1 1 1 1 1 1 1 1 1 1 1 1 1 1 1 1 1 1 1 1 1 1 1 1 1 1 1 1 1 1
1 1 1 1 1 1 1 1 1 1 1 1 1 1 1 1 1 1 1 1 1 1 1 1 1 1 1 1 1 1 1 1 1 1 1 1 1 1 1 1 1 1 1 1 1 1 1 1 1 1
1 1 1 1 1 1 1 1 1 1 1 1 1 1 1 1 1 1 1 1 1 1 1 1 1 1 1 1 1 1 1 1 1 1 1 1 1 1 1 1 1 1 1 1 1 1 1 1 1 1